r.sex	sex
r.car	car
r.bed	bed
r.eat	eat
r.ace	ace
r.art	art
r.bar	bar
r.red	red
r.cat	cat
r.egg	egg
r.rat	rat
r.fat	fat
r.war	war
r.sad	sad
r.arm	arm
r.god	god
r.dog	dog
r.wit	wit
r.air	air
r.cow	cow
r.bus	bus
r.fur	fur
r.cut	cut
r.win	win
r.fun	fun
r.sun	sun
r.sky	sky
r.toy	toy
r.boy	boy
r.shy	shy
r.gun	gun
r.sin	sin
r.pet	pet
r.hat	hat
r.odd	odd
r.mad	mad
r.man	man
r.owl	owl
r.key	key
r.hay	hay
r.hug	hug
r.pie	pie
r.jug	jug
r.pig	pig
r.hit	hit
r.pus	pus
r.lie	lie
r.joy	joy
r.ink	ink
r.nun	nun
r.free	free
r.star	star
r.safe	safe
r.zest	zest
r.awed	awed
r.save	save
r.face	face
r.tree	tree
r.vest	vest
r.seat	seat
r.scar	scar
r.bees	bees
r.fear	fear
r.rage	rage
r.debt	debt
r.dead	dead
r.cash	cash
r.baby	baby
r.sexy	sexy
r.bath	bath
r.easy	easy
r.dawn	dawn
r.farm	farm
r.taxi	taxi
r.dark	dark
r.wasp	wasp
r.fame	fame
r.cake	cake
r.game	game
r.bake	bake
r.frog	frog
r.cane	cane
r.ache	ache
r.rape	rape
r.grin	grin
r.tank	tank
r.rain	rain
r.army	army
r.fall	fall
r.cell	cell
r.evil	evil
r.scum	scum
r.gift	gift
r.cute	cute
r.wise	wise
r.bird	bird
r.soft	soft
r.dove	dove
r.wife	wife
r.flag	flag
r.cord	cord
r.dirt	dirt
r.fire	fire
r.rude	rude
r.cozy	cozy
r.wish	wish
r.girl	girl
r.tidy	tidy
r.foam	foam
r.fish	fish
r.city	city
r.rock	rock
r.body	body
r.bowl	bowl
r.fork	fork
r.cork	cork
r.slap	slap
r.burn	burn
r.sick	sick
r.food	food
r.gold	gold
r.good	good
r.song	song
r.snow	snow
r.tune	tune
r.bold	bold
r.blue	blue
r.wine	wine
r.time	time
r.door	door
r.foot	foot
r.cold	cold
r.slow	slow
r.sour	sour
r.snob	snob
r.riot	riot
r.tomb	tomb
r.bomb	bomb
r.wink	wink
r.silk	silk
r.cook	cook
r.doll	doll
r.coin	coin
r.book	book
r.ship	ship
r.chin	chin
r.tool	tool
r.dump	dump
r.foul	foul
r.slum	slum
r.idea	idea
r.news	news
r.hard	hard
r.part	part
r.pest	pest
r.hate	hate
r.heal	heal
r.hawk	hawk
r.item	item
r.lawn	lawn
r.obey	obey
r.lazy	lazy
r.meek	meek
r.lake	lake
r.hand	hand
r.lamb	lamb
r.name	name
r.mail	mail
r.idol	idol
r.lamp	lamp
r.iron	iron
r.ugly	ugly
r.hell	hell
r.pain	pain
r.jail	jail
r.love	love
r.kiss	kiss
r.life	life
r.lust	lust
r.kids	kids
r.nude	nude
r.nice	nice
r.hide	hide
r.lost	lost
r.lice	lice
r.hurt	hurt
r.kick	kick
r.pity	pity
r.joke	joke
r.home	home
r.kind	kind
r.king	king
r.hope	hope
r.mind	mind
r.unit	unit
r.knot	knot
r.mold	mold
r.milk	milk
r.lion	lion
r.lump	lump
r.treat	treat
r.brave	brave
r.greet	greet
r.taste	taste
r.water	water
r.dress	dress
r.grass	grass
r.tease	tease
r.beast	beast
r.greed	greed
r.waste	waste
r.fever	fever
r.beach	beach
r.earth	earth
r.dream	dream
r.green	green
r.watch	watch
r.weary	weary
r.trash	trash
r.crash	crash
r.death	death
r.favor	favor
r.event	event
r.table	table
r.razor	razor
r.germs	germs
r.fraud	fraud
r.radio	radio
r.wagon	wagon
r.swamp	swamp
r.devil	devil
r.bride	bride
r.trust	trust
r.swift	swift
r.salad	salad
r.stove	stove
r.stiff	stiff
r.tense	tense
r.FALSE	FALSE
r.crude	crude
r.abuse	abuse
r.grief	grief
r.truth	truth
r.crown	crown
r.candy	candy
r.truck	truck
r.storm	storm
r.bench	bench
r.scorn	scorn
r.cruel	cruel
r.drown	drown
r.adult	adult
r.saint	saint
r.fault	fault
r.grime	grime
r.gripe	gripe
r.crime	crime
r.trunk	trunk
r.stool	stool
r.stink	stink
r.venom	venom
r.agony	agony
r.demon	demon
r.cheer	cheer
r.bless	bless
r.river	river
r.space	space
r.sugar	sugar
r.diver	diver
r.alert	alert
r.coast	coast
r.boxer	boxer
r.tower	tower
r.quart	quart
r.blase	blase
r.board	board
r.glass	glass
r.bored	bored
r.anger	anger
r.slave	slave
r.angel	angel
r.sleep	sleep
r.charm	charm
r.queen	queen
r.spray	spray
r.black	black
r.rusty	rusty
r.shark	shark
r.sissy	sissy
r.dirty	dirty
r.angry	angry
r.roach	roach
r.world	world
r.field	field
r.elbow	elbow
r.chair	chair
r.chaos	chaos
r.bland	bland
r.rifle	rifle
r.fight	fight
r.rigid	rigid
r.snake	snake
r.toxic	toxic
r.champ	champ
r.flirt	flirt
r.alive	alive
r.bliss	bliss
r.white	white
r.quiet	quiet
r.cliff	cliff
r.whore	whore
r.thief	thief
r.glory	glory
r.quick	quick
r.woman	woman
r.alien	alien
r.clock	clock
r.rough	rough
r.slush	slush
r.alley	alley
r.thorn	thorn
r.filth	filth
r.child	child
r.color	color
r.blond	blond
r.ankle	ankle
r.aloof	aloof
r.timid	timid
r.flood	flood
r.blind	blind
r.slime	slime
r.alone	alone
r.tumor	tumor
r.vomit	vomit
r.silly	silly
r.bunny	bunny
r.ennui	ennui
r.skull	skull
r.dummy	dummy
r.annoy	annoy
r.gloom	gloom
r.peace	peace
r.heart	heart
r.pasta	pasta
r.merry	merry
r.party	party
r.learn	learn
r.ocean	ocean
r.jewel	jewel
r.metal	metal
r.nasty	nasty
r.messy	messy
r.yacht	yacht
r.habit	habit
r.pride	pride
r.naked	naked
r.paper	paper
r.prick	prick
r.proud	proud
r.penis	penis
r.paint	paint
r.urine	urine
r.idiot	idiot
r.panic	panic
r.happy	happy
r.jelly	jelly
r.loved	loved
r.pizza	pizza
r.power	power
r.nurse	nurse
r.horse	horse
r.phase	phase
r.loser	loser
r.upset	upset
r.ulcer	ulcer
r.moral	moral
r.hotel	hotel
r.muddy	muddy
r.music	music
r.movie	movie
r.plane	plane
r.plant	plant
r.mucus	mucus
r.lucky	lucky
r.plain	plain
r.house	house
r.noose	noose
r.knife	knife
r.louse	louse
r.money	money
r.loyal	loyal
r.youth	youth
r.honey	honey
r.month	month
r.noisy	noisy
r.pinch	pinch
r.moody	moody
r.humor	humor
r.honor	honor
r.young	young
r.puppy	puppy
r.jolly	jolly
r.caress	caress
r.reward	reward
r.breeze	breeze
r.breast	breast
r.garter	garter
r.street	street
r.dagger	dagger
r.beggar	beggar
r.severe	severe
r.scared	scared
r.detest	detest
r.stress	stress
r.travel	travel
r.garden	garden
r.barrel	barrel
r.scream	scream
r.dreary	dreary
r.betray	betray
r.rescue	rescue
r.dazzle	dazzle
r.rabbit	rabbit
r.fabric	fabric
r.statue	statue
r.rattle	rattle
r.errand	errand
r.resent	resent
r.feeble	feeble
r.deceit	deceit
r.afraid	afraid
r.detail	detail
r.desire	desire
r.secure	secure
r.father	father
r.basket	basket
r.absurd	absurd
r.excuse	excuse
r.addict	addict
r.rabies	rabies
r.beauty	beauty
r.warmth	warmth
r.stench	stench
r.savior	savior
r.strong	strong
r.vagina	vagina
r.avenue	avenue
r.revolt	revolt
r.trauma	trauma
r.casino	casino
r.weapon	weapon
r.dancer	dancer
r.tender	tender
r.gender	gender
r.writer	writer
r.square	square
r.damage	damage
r.danger	danger
r.cancer	cancer
r.crutch	crutch
r.scurvy	scurvy
r.brutal	brutal
r.vandal	vandal
r.friend	friend
r.talent	talent
r.bright	bright
r.erotic	erotic
r.gentle	gentle
r.rancid	rancid
r.frigid	frigid
r.crisis	crisis
r.salute	salute
r.banner	banner
r.cellar	cellar
r.tamper	tamper
r.vanity	vanity
r.broken	broken
r.famous	famous
r.tennis	tennis
r.stupid	stupid
r.trophy	trophy
r.family	family
r.cannon	cannon
r.elated	elated
r.answer	answer
r.butter	butter
r.coarse	coarse
r.coward	coward
r.robber	robber
r.flabby	flabby
r.rotten	rotten
r.cuddle	cuddle
r.circus	circus
r.virtue	virtue
r.bottle	bottle
r.circle	circle
r.doctor	doctor
r.shadow	shadow
r.virgin	virgin
r.custom	custom
r.gossip	gossip
r.coffin	coffin
r.victim	victim
r.riches	riches
r.chance	chance
r.corner	corner
r.wicked	wicked
r.shamed	shamed
r.corpse	corpse
r.social	social
r.theory	theory
r.shriek	shriek
r.burial	burial
r.spring	spring
r.engine	engine
r.thrill	thrill
r.vision	vision
r.autumn	autumn
r.sunset	sunset
r.flower	flower
r.voyage	voyage
r.wonder	wonder
r.golfer	golfer
r.sphere	sphere
r.finger	finger
r.spider	spider
r.comedy	comedy
r.church	church
r.soothe	soothe
r.spirit	spirit
r.window	window
r.fungus	fungus
r.solemn	solemn
r.sinful	sinful
r.spouse	spouse
r.dollar	dollar
r.dinner	dinner
r.clouds	clouds
r.runner	runner
r.bullet	bullet
r.wounds	wounds
r.smooth	smooth
r.clumsy	clumsy
r.bloody	bloody
r.guilty	guilty
r.couple	couple
r.violin	violin
r.column	column
r.leader	leader
r.nectar	nectar
r.letter	letter
r.hatred	hatred
r.orgasm	orgasm
r.pretty	pretty
r.heaven	heaven
r.legend	legend
r.patent	patent
r.kettle	kettle
r.icebox	icebox
r.needle	needle
r.offend	offend
r.maggot	maggot
r.useful	useful
r.person	person
r.nature	nature
r.market	market
r.office	office
r.health	health
r.lavish	lavish
r.madman	madman
r.method	method
r.heroin	heroin
r.palace	palace
r.priest	priest
r.menace	menace
r.mantel	mantel
r.profit	profit
r.mangle	mangle
r.pencil	pencil
r.prison	prison
r.manner	manner
r.hammer	hammer
r.maniac	maniac
r.manure	manure
r.malice	malice
r.melody	melody
r.memory	memory
r.people	people
r.yellow	yellow
r.invest	invest
r.modest	modest
r.poster	poster
r.insect	insect
r.kitten	kitten
r.poetry	poetry
r.misery	misery
r.infant	infant
r.mystic	mystic
r.morbid	morbid
r.insane	insane
r.horror	horror
r.putrid	putrid
r.morgue	morgue
r.lively	lively
r.muffin	muffin
r.museum	museum
r.pistol	pistol
r.mother	mother
r.locker	locker
r.luxury	luxury
r.mighty	mighty
r.insult	insult
r.option	option
r.python	python
r.honest	honest
r.limber	limber
r.hinder	hinder
r.mildew	mildew
r.hungry	hungry
r.humane	humane
r.humble	humble
r.moment	moment
r.impair	impair
r.joyful	joyful
r.lonely	lonely
r.poison	poison
r.hooker	hooker
r.killer	killer
r.injury	injury
r.pillow	pillow
r.nipple	nipple
r.bastard	bastard
r.carcass	carcass
r.garbage	garbage
r.ecstasy	ecstasy
r.tragedy	tragedy
r.freedom	freedom
r.destroy	destroy
r.fearful	fearful
r.festive	festive
r.teacher	teacher
r.seasick	seasick
r.wedding	wedding
r.assault	assault
r.respect	respect
r.devoted	devoted
r.grenade	grenade
r.scandal	scandal
r.radiant	radiant
r.bathtub	bathtub
r.garment	garment
r.defiant	defiant
r.traitor	traitor
r.wealthy	wealthy
r.cabinet	cabinet
r.termite	termite
r.despise	despise
r.serious	serious
r.relaxed	relaxed
r.bandage	bandage
r.fantasy	fantasy
r.capable	capable
r.brother	brother
r.dentist	dentist
r.delayed	delayed
r.crushed	crushed
r.selfish	selfish
r.crucify	crucify
r.reptile	reptile
r.aroused	aroused
r.admired	admired
r.stomach	stomach
r.delight	delight
r.rainbow	rainbow
r.vehicle	vehicle
r.trouble	trouble
r.scholar	scholar
r.swimmer	swimmer
r.trumpet	trumpet
r.vampire	vampire
r.failure	failure
r.agility	agility
r.triumph	triumph
r.reunion	reunion
r.success	success
r.engaged	engaged
r.cottage	cottage
r.enraged	enraged
r.tobacco	tobacco
r.quarrel	quarrel
r.surgery	surgery
r.elegant	elegant
r.glacier	glacier
r.subdued	subdued
r.disturb	disturb
r.torture	torture
r.victory	victory
r.dustpan	dustpan
r.corrupt	corrupt
r.divorce	divorce
r.tornado	tornado
r.quality	quality
r.diamond	diamond
r.glamour	glamour
r.curious	curious
r.anxious	anxious
r.cyclone	cyclone
r.context	context
r.blubber	blubber
r.blister	blister
r.allergy	allergy
r.funeral	funeral
r.snuggle	snuggle
r.whistle	whistle
r.blossom	blossom
r.volcano	volcano
r.shotgun	shotgun
r.sunrise	sunrise
r.comfort	comfort
r.bouquet	bouquet
r.suicide	suicide
r.cuisine	cuisine
r.gymnast	gymnast
r.village	village
r.thought	thought
r.violent	violent
r.diploma	diploma
r.skijump	skijump
r.alimony	alimony
r.passage	passage
r.pervert	pervert
r.present	present
r.obscene	obscene
r.measles	measles
r.lesbian	lesbian
r.obesity	obesity
r.perfume	perfume
r.patriot	patriot
r.lawsuit	lawsuit
r.nervous	nervous
r.passion	passion
r.ketchup	ketchup
r.neglect	neglect
r.useless	useless
r.magical	magical
r.natural	natural
r.prairie	prairie
r.patient	patient
r.utensil	utensil
r.machine	machine
r.privacy	privacy
r.lantern	lantern
r.malaria	malaria
r.penalty	penalty
r.leprosy	leprosy
r.hairpin	hairpin
r.outrage	outrage
r.invader	invader
r.hostage	hostage
r.liberty	liberty
r.lottery	lottery
r.nursery	nursery
r.poverty	poverty
r.miracle	miracle
r.hydrant	hydrant
r.mistake	mistake
r.justice	justice
r.history	history
r.imagine	imagine
r.hostile	hostile
r.highway	highway
r.inspire	inspire
r.pungent	pungent
r.hopeful	hopeful
r.improve	improve
r.nourish	nourish
r.journal	journal
r.unhappy	unhappy
r.illness	illness
r.holiday	holiday
r.immoral	immoral
r.pollute	pollute
r.opinion	opinion
r.carefree	carefree
r.beverage	beverage
r.reserved	reserved
r.deserter	deserter
r.defeated	defeated
r.reverent	reverent
r.grateful	grateful
r.assassin	assassin
r.dreadful	dreadful
r.treasure	treasure
r.exercise	exercise
r.startled	startled
r.detached	detached
r.starving	starving
r.vacation	vacation
r.graduate	graduate
r.terrific	terrific
r.stagnant	stagnant
r.terrible	terrible
r.derelict	derelict
r.decorate	decorate
r.activate	activate
r.addicted	addicted
r.radiator	radiator
r.arrogant	arrogant
r.accident	accident
r.fatigued	fatigued
r.deformed	deformed
r.scalding	scalding
r.bathroom	bathroom
r.revolver	revolver
r.rejected	rejected
r.cemetery	cemetery
r.adorable	adorable
r.gangrene	gangrene
r.scissors	scissors
r.abortion	abortion
r.friendly	friendly
r.scornful	scornful
r.scorpion	scorpion
r.sailboat	sailboat
r.troubled	troubled
r.bankrupt	bankrupt
r.twilight	twilight
r.daylight	daylight
r.sapphire	sapphire
r.criminal	criminal
r.disaster	disaster
r.elevator	elevator
r.burdened	burdened
r.curtains	curtains
r.birthday	birthday
r.corridor	corridor
r.busybody	busybody
r.vigorous	vigorous
r.ridicule	ridicule
r.ambition	ambition
r.sickness	sickness
r.thankful	thankful
r.disloyal	disloyal
r.spanking	spanking
r.smallpox	smallpox
r.champion	champion
r.contents	contents
r.contempt	contempt
r.confused	confused
r.romantic	romantic
r.consoled	consoled
r.clothing	clothing
r.windmill	windmill
r.applause	applause
r.building	building
r.computer	computer
r.sunlight	sunlight
r.syphilis	syphilis
r.overcast	overcast
r.massacre	massacre
r.headache	headache
r.paradise	paradise
r.prestige	prestige
r.pressure	pressure
r.material	material
r.hardship	hardship
r.narcotic	narcotic
r.kerchief	kerchief
r.irritate	irritate
r.kerosene	kerosene
r.identity	identity
r.medicine	medicine
r.jealousy	jealousy
r.progress	progress
r.pancakes	pancakes
r.handsome	handsome
r.laughter	laughter
r.handicap	handicap
r.neurotic	neurotic
r.memories	memories
r.helpless	helpless
r.pamphlet	pamphlet
r.interest	interest
r.murderer	murderer
r.powerful	powerful
r.pleasure	pleasure
r.insecure	insecure
r.umbrella	umbrella
r.inferior	inferior
r.mutation	mutation
r.listless	listless
r.intruder	intruder
r.outdoors	outdoors
r.muscular	muscular
r.mischief	mischief
r.mosquito	mosquito
r.luscious	luscious
r.industry	industry
r.mushroom	mushroom
r.intimate	intimate
r.inspired	inspired
r.mutilate	mutilate
r.hospital	hospital
r.insolent	insolent
r.optimism	optimism
r.mobility	mobility
r.nonsense	nonsense
r.immature	immature
r.nuisance	nuisance
r.kindness	kindness
r.innocent	innocent
r.impotent	impotent
r.mountain	mountain
r.waterfall	waterfall
r.regretful	regretful
r.fragrance	fragrance
r.affection	affection
r.agreement	agreement
r.advantage	advantage
r.adventure	adventure
r.terrified	terrified
r.terrorist	terrorist
r.execution	execution
r.fascinate	fascinate
r.astronaut	astronaut
r.satisfied	satisfied
r.scapegoat	scapegoat
r.abduction	abduction
r.avalanche	avalanche
r.beautiful	beautiful
r.easygoing	easygoing
r.decompose	decompose
r.depressed	depressed
r.education	education
r.scorching	scorching
r.repentant	repentant
r.valentine	valentine
r.sentiment	sentiment
r.athletics	athletics
r.abundance	abundance
r.butterfly	butterfly
r.embattled	embattled
r.fireworks	fireworks
r.disgusted	disgusted
r.suffocate	suffocate
r.blasphemy	blasphemy
r.blackmail	blackmail
r.sheltered	sheltered
r.christmas	christmas
r.surprised	surprised
r.slaughter	slaughter
r.skeptical	skeptical
r.cockroach	cockroach
r.dignified	dignified
r.ambulance	ambulance
r.anguished	anguished
r.alcoholic	alcoholic
r.confident	confident
r.toothache	toothache
r.chocolate	chocolate
r.appliance	appliance
r.enjoyment	enjoyment
r.masterful	masterful
r.obsession	obsession
r.headlight	headlight
r.paralysis	paralysis
r.orchestra	orchestra
r.protected	protected
r.hairdryer	hairdryer
r.hamburger	hamburger
r.leisurely	leisurely
r.penthouse	penthouse
r.haphazard	haphazard
r.ignorance	ignorance
r.obnoxious	obnoxious
r.promotion	promotion
r.infection	infection
r.hurricane	hurricane
r.incentive	incentive
r.intellect	intellect
r.lightbulb	lightbulb
r.nightmare	nightmare
r.lightning	lightning
r.impressed	impressed
r.knowledge	knowledge
r.humiliate	humiliate
r.aggressive	aggressive
r.sweetheart	sweetheart
r.restaurant	restaurant
r.acceptance	acceptance
r.excellence	excellence
r.respectful	respectful
r.excitement	excitement
r.despairing	despairing
r.astonished	astonished
r.frustrated	frustrated
r.depression	depression
r.triumphant	triumphant
r.distressed	distressed
r.disdainful	disdainful
r.discomfort	discomfort
r.disappoint	disappoint
r.displeased	displeased
r.suspicious	suspicious
r.skyscraper	skyscraper
r.thoughtful	thoughtful
r.guillotine	guillotine
r.employment	employment
r.perfection	perfection
r.masturbate	masturbate
r.unfaithful	unfaithful
r.untroubled	untroubled
r.lighthouse	lighthouse
r.inhabitant	inhabitant
r.nonchalant	nonchalant
r.loneliness	loneliness
r.politeness	politeness
r.punishment	punishment
r.bereavement	bereavement
r.refreshment	refreshment
r.destruction	destruction
r.achievement	achievement
r.embarrassed	embarrassed
r.discouraged	discouraged
r.thermometer	thermometer
r.concentrate	concentrate
r.controlling	controlling
r.overwhelmed	overwhelmed
r.outstanding	outstanding
r.intercourse	intercourse
r.infatuation	infatuation
r.indifferent	indifferent
r.millionaire	millionaire
r.rollercoaster	rollercoaster
f.bague	bague
f.bashe	bashe
f.bave	bave
f.beeg	beeg
f.beesh	beesh
f.beeve	beeve
f.blabe	blabe
f.blafe	blafe
f.blage	blage
f.blague	blague
f.blale	blale
f.blashe	blashe
f.blathe	blathe
f.blave	blave
f.bleeb	bleeb
f.bleef	bleef
f.bleeg	bleeg
f.bleege	bleege
f.bleel	bleel
f.bleesh	bleesh
f.bleeth	bleeth
f.bleeve	bleeve
f.blobe	blobe
f.blofe	blofe
f.bloge	bloge
f.blogue	blogue
f.blole	blole
f.bloob	bloob
f.bloof	bloof
f.bloog	bloog
f.blooge	blooge
f.blool	blool
f.bloosh	bloosh
f.blooth	blooth
f.bloove	bloove
f.bloshe	bloshe
f.blothe	blothe
f.blove	blove
f.bogue	bogue
f.boog	boog
f.boosh	boosh
f.boove	boove
f.boshe	boshe
f.bove	bove
f.brabe	brabe
f.brage	brage
f.brague	brague
f.brape	brape
f.brare	brare
f.brashe	brashe
f.brathe	brathe
f.breeb	breeb
f.breeg	breeg
f.breege	breege
f.breep	breep
f.breer	breer
f.breesh	breesh
f.breeth	breeth
f.brobe	brobe
f.broge	broge
f.brogue	brogue
f.broob	broob
f.broog	broog
f.brooge	brooge
f.broop	broop
f.broor	broor
f.broosh	broosh
f.brooth	brooth
f.brope	brope
f.brore	brore
f.broshe	broshe
f.brothe	brothe
f.chabe	chabe
f.chade	chade
f.chage	chage
f.chague	chague
f.chale	chale
f.chame	chame
f.chathe	chathe
f.cheeb	cheeb
f.cheed	cheed
f.cheeg	cheeg
f.cheege	cheege
f.cheel	cheel
f.cheem	cheem
f.cheeth	cheeth
f.chobe	chobe
f.chode	chode
f.choge	choge
f.chogue	chogue
f.chole	chole
f.chome	chome
f.choob	choob
f.chood	chood
f.choog	choog
f.chooge	chooge
f.chool	chool
f.choom	choom
f.chooth	chooth
f.chothe	chothe
f.dabe	dabe
f.dache	dache
f.dafe	dafe
f.dague	dague
f.dathe	dathe
f.deeb	deeb
f.deech	deech
f.deef	deef
f.deeg	deeg
f.deeth	deeth
f.dobe	dobe
f.doche	doche
f.dofe	dofe
f.dogue	dogue
f.doob	doob
f.dooch	dooch
f.doof	doof
f.doog	doog
f.dooth	dooth
f.dothe	dothe
f.drabe	drabe
f.drache	drache
f.drade	drade
f.drafe	drafe
f.drage	drage
f.drague	drague
f.drare	drare
f.drase	drase
f.drate	drate
f.drathe	drathe
f.draze	draze
f.dreeb	dreeb
f.dreech	dreech
f.dreed	dreed
f.dreef	dreef
f.dreeg	dreeg
f.dreege	dreege
f.dreer	dreer
f.dreese	dreese
f.dreet	dreet
f.dreeth	dreeth
f.dreeze	dreeze
f.drobe	drobe
f.droche	droche
f.drode	drode
f.drofe	drofe
f.droge	droge
f.drogue	drogue
f.droob	droob
f.drooch	drooch
f.drood	drood
f.droof	droof
f.droog	droog
f.drooge	drooge
f.droor	droor
f.droose	droose
f.droot	droot
f.drooth	drooth
f.drooze	drooze
f.drore	drore
f.drose	drose
f.drote	drote
f.drothe	drothe
f.droze	droze
f.dwache	dwache
f.dwade	dwade
f.dwafe	dwafe
f.dwage	dwage
f.dwague	dwague
f.dwake	dwake
f.dwale	dwale
f.dwame	dwame
f.dwane	dwane
f.dwape	dwape
f.dware	dware
f.dwase	dwase
f.dwashe	dwashe
f.dwate	dwate
f.dwathe	dwathe
f.dwave	dwave
f.dwaze	dwaze
f.dweech	dweech
f.dweed	dweed
f.dweef	dweef
f.dweeg	dweeg
f.dweege	dweege
f.dweek	dweek
f.dweel	dweel
f.dweem	dweem
f.dween	dween
f.dweep	dweep
f.dweer	dweer
f.dweese	dweese
f.dweesh	dweesh
f.dweet	dweet
f.dweeth	dweeth
f.dweeve	dweeve
f.dweeze	dweeze
f.dwoche	dwoche
f.dwode	dwode
f.dwofe	dwofe
f.dwoge	dwoge
f.dwogue	dwogue
f.dwoke	dwoke
f.dwole	dwole
f.dwome	dwome
f.dwone	dwone
f.dwooch	dwooch
f.dwood	dwood
f.dwoof	dwoof
f.dwoog	dwoog
f.dwooge	dwooge
f.dwook	dwook
f.dwool	dwool
f.dwoom	dwoom
f.dwoon	dwoon
f.dwoop	dwoop
f.dwoor	dwoor
f.dwoose	dwoose
f.dwoosh	dwoosh
f.dwoot	dwoot
f.dwooth	dwooth
f.dwoove	dwoove
f.dwooze	dwooze
f.dwope	dwope
f.dwore	dwore
f.dwose	dwose
f.dwoshe	dwoshe
f.dwote	dwote
f.dwothe	dwothe
f.dwove	dwove
f.dwoze	dwoze
f.fabe	fabe
f.fache	fache
f.fafe	fafe
f.fague	fague
f.fape	fape
f.feeb	feeb
f.feech	feech
f.feef	feef
f.feeg	feeg
f.feep	feep
f.flabe	flabe
f.flache	flache
f.flafe	flafe
f.flage	flage
f.flague	flague
f.flape	flape
f.flashe	flashe
f.flathe	flathe
f.flave	flave
f.fleeb	fleeb
f.fleech	fleech
f.fleef	fleef
f.fleeg	fleeg
f.fleege	fleege
f.fleep	fleep
f.fleesh	fleesh
f.fleeth	fleeth
f.fleeve	fleeve
f.flobe	flobe
f.floche	floche
f.flofe	flofe
f.floge	floge
f.flogue	flogue
f.floob	floob
f.flooch	flooch
f.floof	floof
f.floog	floog
f.flooge	flooge
f.floop	floop
f.floosh	floosh
f.flooth	flooth
f.floove	floove
f.flope	flope
f.floshe	floshe
f.flothe	flothe
f.flove	flove
f.fobe	fobe
f.foche	foche
f.fofe	fofe
f.fogue	fogue
f.foob	foob
f.fooch	fooch
f.foof	foof
f.foog	foog
f.foop	foop
f.fope	fope
f.frabe	frabe
f.frache	frache
f.frafe	frafe
f.frage	frage
f.frague	frague
f.frape	frape
f.frashe	frashe
f.frathe	frathe
f.frave	frave
f.freeb	freeb
f.freech	freech
f.freef	freef
f.freeg	freeg
f.freege	freege
f.freep	freep
f.freesh	freesh
f.freeth	freeth
f.freeve	freeve
f.frobe	frobe
f.froche	froche
f.frofe	frofe
f.froge	froge
f.frogue	frogue
f.froob	froob
f.frooch	frooch
f.froof	froof
f.froog	froog
f.frooge	frooge
f.froop	froop
f.froosh	froosh
f.frooth	frooth
f.froove	froove
f.frope	frope
f.froshe	froshe
f.frothe	frothe
f.frove	frove
f.gache	gache
f.gathe	gathe
f.geech	geech
f.geeth	geeth
f.glache	glache
f.glafe	glafe
f.glage	glage
f.glague	glague
f.glake	glake
f.glale	glale
f.glase	glase
f.glashe	glashe
f.glathe	glathe
f.gleech	gleech
f.gleef	gleef
f.gleeg	gleeg
f.gleege	gleege
f.gleek	gleek
f.gleel	gleel
f.gleese	gleese
f.gleesh	gleesh
f.gleeth	gleeth
f.gloche	gloche
f.glofe	glofe
f.gloge	gloge
f.glogue	glogue
f.gloke	gloke
f.glole	glole
f.glooch	glooch
f.gloof	gloof
f.gloog	gloog
f.glooge	glooge
f.glook	glook
f.glool	glool
f.gloose	gloose
f.gloosh	gloosh
f.glooth	glooth
f.glose	glose
f.gloshe	gloshe
f.glothe	glothe
f.goche	goche
f.gooch	gooch
f.gooth	gooth
f.gothe	gothe
f.grabe	grabe
f.grache	grache
f.grage	grage
f.grague	grague
f.grare	grare
f.grashe	grashe
f.greeb	greeb
f.greech	greech
f.greeg	greeg
f.greege	greege
f.greer	greer
f.greesh	greesh
f.grobe	grobe
f.groche	groche
f.groge	groge
f.grogue	grogue
f.groob	groob
f.grooch	grooch
f.groog	groog
f.grooge	grooge
f.groor	groor
f.groosh	groosh
f.grore	grore
f.groshe	groshe
f.gwabe	gwabe
f.gwache	gwache
f.gwade	gwade
f.gwafe	gwafe
f.gwage	gwage
f.gwague	gwague
f.gwake	gwake
f.gwale	gwale
f.gwame	gwame
f.gwane	gwane
f.gwape	gwape
f.gware	gware
f.gwase	gwase
f.gwashe	gwashe
f.gwate	gwate
f.gwathe	gwathe
f.gwave	gwave
f.gwaze	gwaze
f.gweeb	gweeb
f.gweech	gweech
f.gweed	gweed
f.gweef	gweef
f.gweeg	gweeg
f.gweege	gweege
f.gweek	gweek
f.gweel	gweel
f.gweem	gweem
f.gween	gween
f.gweep	gweep
f.gweer	gweer
f.gweese	gweese
f.gweesh	gweesh
f.gweet	gweet
f.gweeth	gweeth
f.gweeve	gweeve
f.gweeze	gweeze
f.gwobe	gwobe
f.gwoche	gwoche
f.gwode	gwode
f.gwofe	gwofe
f.gwoge	gwoge
f.gwogue	gwogue
f.gwoke	gwoke
f.gwole	gwole
f.gwome	gwome
f.gwone	gwone
f.gwoob	gwoob
f.gwooch	gwooch
f.gwood	gwood
f.gwoof	gwoof
f.gwoog	gwoog
f.gwooge	gwooge
f.gwook	gwook
f.gwool	gwool
f.gwoom	gwoom
f.gwoon	gwoon
f.gwoop	gwoop
f.gwoor	gwoor
f.gwoose	gwoose
f.gwoosh	gwoosh
f.gwoot	gwoot
f.gwooth	gwooth
f.gwoove	gwoove
f.gwooze	gwooze
f.gwope	gwope
f.gwore	gwore
f.gwose	gwose
f.gwoshe	gwoshe
f.gwote	gwote
f.gwothe	gwothe
f.gwove	gwove
f.gwoze	gwoze
f.jabe	jabe
f.jache	jache
f.jafe	jafe
f.jague	jague
f.jame	jame
f.jashe	jashe
f.jate	jate
f.jathe	jathe
f.jeeb	jeeb
f.jeech	jeech
f.jeef	jeef
f.jeeg	jeeg
f.jeem	jeem
f.jeesh	jeesh
f.jeet	jeet
f.jeeth	jeeth
f.jobe	jobe
f.joche	joche
f.jofe	jofe
f.jogue	jogue
f.jome	jome
f.joob	joob
f.jooch	jooch
f.joof	joof
f.joog	joog
f.joom	joom
f.joosh	joosh
f.joot	joot
f.jooth	jooth
f.joshe	joshe
f.jote	jote
f.jothe	jothe
f.kabe	kabe
f.kague	kague
f.keeb	keeb
f.keeg	keeg
f.klabe	klabe
f.klache	klache
f.klade	klade
f.klafe	klafe
f.klague	klague
f.klale	klale
f.klape	klape
f.klashe	klashe
f.kleeb	kleeb
f.kleech	kleech
f.kleed	kleed
f.kleef	kleef
f.kleeg	kleeg
f.kleel	kleel
f.kleep	kleep
f.kleesh	kleesh
f.klobe	klobe
f.kloche	kloche
f.klode	klode
f.klofe	klofe
f.klogue	klogue
f.klole	klole
f.kloob	kloob
f.klooch	klooch
f.klood	klood
f.kloof	kloof
f.kloog	kloog
f.klool	klool
f.kloop	kloop
f.kloosh	kloosh
f.klope	klope
f.kloshe	kloshe
f.kobe	kobe
f.kogue	kogue
f.koob	koob
f.koog	koog
f.krabe	krabe
f.krache	krache
f.krafe	krafe
f.krage	krage
f.krague	krague
f.krare	krare
f.krashe	krashe
f.krathe	krathe
f.kreeb	kreeb
f.kreech	kreech
f.kreef	kreef
f.kreeg	kreeg
f.kreege	kreege
f.kreer	kreer
f.kreesh	kreesh
f.kreeth	kreeth
f.krobe	krobe
f.kroche	kroche
f.krofe	krofe
f.kroge	kroge
f.krogue	krogue
f.kroob	kroob
f.krooch	krooch
f.kroof	kroof
f.kroog	kroog
f.krooge	krooge
f.kroor	kroor
f.kroosh	kroosh
f.krooth	krooth
f.krore	krore
f.kroshe	kroshe
f.krothe	krothe
f.kwabe	kwabe
f.kwache	kwache
f.kwade	kwade
f.kwage	kwage
f.kwague	kwague
f.kwame	kwame
f.kwape	kwape
f.kwase	kwase
f.kwashe	kwashe
f.kwave	kwave
f.kwaze	kwaze
f.kweeb	kweeb
f.kweech	kweech
f.kweed	kweed
f.kweeg	kweeg
f.kweege	kweege
f.kweem	kweem
f.kweep	kweep
f.kweese	kweese
f.kweesh	kweesh
f.kweeve	kweeve
f.kweeze	kweeze
f.kwobe	kwobe
f.kwoche	kwoche
f.kwode	kwode
f.kwoge	kwoge
f.kwogue	kwogue
f.kwome	kwome
f.kwoob	kwoob
f.kwooch	kwooch
f.kwood	kwood
f.kwoog	kwoog
f.kwooge	kwooge
f.kwoom	kwoom
f.kwoop	kwoop
f.kwoose	kwoose
f.kwoosh	kwoosh
f.kwoove	kwoove
f.kwooze	kwooze
f.kwope	kwope
f.kwose	kwose
f.kwoshe	kwoshe
f.kwove	kwove
f.kwoze	kwoze
f.lache	lache
f.lale	lale
f.lashe	lashe
f.leech	leech
f.leel	leel
f.leesh	leesh
f.loche	loche
f.lole	lole
f.looch	looch
f.lool	lool
f.loosh	loosh
f.loshe	loshe
f.mabe	mabe
f.mafe	mafe
f.mashe	mashe
f.mathe	mathe
f.meeb	meeb
f.meef	meef
f.meesh	meesh
f.meeth	meeth
f.mobe	mobe
f.mofe	mofe
f.moob	moob
f.moof	moof
f.moosh	moosh
f.mooth	mooth
f.moshe	moshe
f.mothe	mothe
f.nabe	nabe
f.nache	nache
f.nafe	nafe
f.nage	nage
f.nague	nague
f.nashe	nashe
f.nathe	nathe
f.neeb	neeb
f.neech	neech
f.neef	neef
f.neeg	neeg
f.neege	neege
f.neesh	neesh
f.neeth	neeth
f.nobe	nobe
f.noche	noche
f.nofe	nofe
f.noge	noge
f.nogue	nogue
f.noob	noob
f.nooch	nooch
f.noof	noof
f.noog	noog
f.nooge	nooge
f.noosh	noosh
f.nooth	nooth
f.noshe	noshe
f.nothe	nothe
f.pabe	pabe
f.pague	pague
f.pame	pame
f.pashe	pashe
f.pathe	pathe
f.peeb	peeb
f.peeg	peeg
f.peem	peem
f.peesh	peesh
f.peeth	peeth
f.plache	plache
f.plafe	plafe
f.plage	plage
f.plake	plake
f.plale	plale
f.plape	plape
f.plare	plare
f.plashe	plashe
f.plathe	plathe
f.plave	plave
f.pleech	pleech
f.pleef	pleef
f.pleege	pleege
f.pleek	pleek
f.pleel	pleel
f.pleep	pleep
f.pleer	pleer
f.pleesh	pleesh
f.pleeth	pleeth
f.pleeve	pleeve
f.ploche	ploche
f.plofe	plofe
f.ploge	ploge
f.ploke	ploke
f.plole	plole
f.plooch	plooch
f.ploof	ploof
f.plooge	plooge
f.plook	plook
f.plool	plool
f.ploop	ploop
f.ploor	ploor
f.ploosh	ploosh
f.plooth	plooth
f.ploove	ploove
f.plope	plope
f.plore	plore
f.ploshe	ploshe
f.plothe	plothe
f.plove	plove
f.pobe	pobe
f.pogue	pogue
f.pome	pome
f.poob	poob
f.poog	poog
f.poom	poom
f.poosh	poosh
f.pooth	pooth
f.poshe	poshe
f.pothe	pothe
f.prache	prache
f.prage	prage
f.prake	prake
f.prale	prale
f.prame	prame
f.prape	prape
f.prashe	prashe
f.prate	prate
f.prathe	prathe
f.preech	preech
f.preege	preege
f.preek	preek
f.preel	preel
f.preem	preem
f.preep	preep
f.preesh	preesh
f.preet	preet
f.preeth	preeth
f.proche	proche
f.proge	proge
f.proke	proke
f.prole	prole
f.prome	prome
f.prooch	prooch
f.prooge	prooge
f.prook	prook
f.prool	prool
f.proom	proom
f.proop	proop
f.proosh	proosh
f.proot	proot
f.prooth	prooth
f.prope	prope
f.proshe	proshe
f.prote	prote
f.prothe	prothe
f.rashe	rashe
f.reesh	reesh
f.roosh	roosh
f.roshe	roshe
f.sabe	sabe
f.sache	sache
f.sague	sague
f.sashe	sashe
f.seeb	seeb
f.seech	seech
f.seeg	seeg
f.seesh	seesh
f.shabe	shabe
f.shache	shache
f.shage	shage
f.shague	shague
f.shase	shase
f.sheeb	sheeb
f.sheech	sheech
f.sheeg	sheeg
f.sheege	sheege
f.sheese	sheese
f.shobe	shobe
f.shoche	shoche
f.shoge	shoge
f.shogue	shogue
f.shoob	shoob
f.shooch	shooch
f.shoog	shoog
f.shooge	shooge
f.shoose	shoose
f.shose	shose
f.shrabe	shrabe
f.shrache	shrache
f.shrafe	shrafe
f.shrage	shrage
f.shrague	shrague
f.shrale	shrale
f.shrame	shrame
f.shrane	shrane
f.shrape	shrape
f.shrare	shrare
f.shrase	shrase
f.shrashe	shrashe
f.shrate	shrate
f.shrathe	shrathe
f.shrave	shrave
f.shraze	shraze
f.shreeb	shreeb
f.shreech	shreech
f.shreef	shreef
f.shreeg	shreeg
f.shreege	shreege
f.shreel	shreel
f.shreem	shreem
f.shreen	shreen
f.shreep	shreep
f.shreer	shreer
f.shreese	shreese
f.shreesh	shreesh
f.shreet	shreet
f.shreeth	shreeth
f.shreeve	shreeve
f.shreeze	shreeze
f.shrobe	shrobe
f.shroche	shroche
f.shrofe	shrofe
f.shroge	shroge
f.shrogue	shrogue
f.shrole	shrole
f.shrome	shrome
f.shrone	shrone
f.shroob	shroob
f.shrooch	shrooch
f.shroof	shroof
f.shroog	shroog
f.shrooge	shrooge
f.shrool	shrool
f.shroom	shroom
f.shroon	shroon
f.shroop	shroop
f.shroor	shroor
f.shroose	shroose
f.shroosh	shroosh
f.shroot	shroot
f.shrooth	shrooth
f.shroove	shroove
f.shrooze	shrooze
f.shrope	shrope
f.shrore	shrore
f.shrose	shrose
f.shroshe	shroshe
f.shrote	shrote
f.shrothe	shrothe
f.shrove	shrove
f.shroze	shroze
f.skabe	skabe
f.skafe	skafe
f.skage	skage
f.skague	skague
f.skake	skake
f.skame	skame
f.skase	skase
f.skashe	skashe
f.skathe	skathe
f.skave	skave
f.skeeb	skeeb
f.skeef	skeef
f.skeeg	skeeg
f.skeege	skeege
f.skeek	skeek
f.skeem	skeem
f.skeese	skeese
f.skeesh	skeesh
f.skeeth	skeeth
f.skeeve	skeeve
f.skobe	skobe
f.skofe	skofe
f.skoge	skoge
f.skogue	skogue
f.skoke	skoke
f.skome	skome
f.skoob	skoob
f.skoof	skoof
f.skoog	skoog
f.skooge	skooge
f.skook	skook
f.skoom	skoom
f.skoose	skoose
f.skoosh	skoosh
f.skooth	skooth
f.skoove	skoove
f.skose	skose
f.skoshe	skoshe
f.skothe	skothe
f.skove	skove
f.slabe	slabe
f.slache	slache
f.slade	slade
f.slafe	slafe
f.slage	slage
f.slague	slague
f.slale	slale
f.slame	slame
f.slare	slare
f.slase	slase
f.slashe	slashe
f.sleeb	sleeb
f.sleech	sleech
f.sleed	sleed
f.sleef	sleef
f.sleeg	sleeg
f.sleege	sleege
f.sleel	sleel
f.sleem	sleem
f.sleer	sleer
f.sleese	sleese
f.sleesh	sleesh
f.slobe	slobe
f.sloche	sloche
f.slode	slode
f.slofe	slofe
f.sloge	sloge
f.slogue	slogue
f.slole	slole
f.slome	slome
f.sloob	sloob
f.slooch	slooch
f.slood	slood
f.sloof	sloof
f.sloog	sloog
f.slooge	slooge
f.slool	slool
f.sloom	sloom
f.sloor	sloor
f.sloose	sloose
f.sloosh	sloosh
f.slore	slore
f.slose	slose
f.sloshe	sloshe
f.smabe	smabe
f.smade	smade
f.smafe	smafe
f.smage	smage
f.smague	smague
f.smale	smale
f.smame	smame
f.smane	smane
f.smape	smape
f.smase	smase
f.smashe	smashe
f.smathe	smathe
f.smave	smave
f.smaze	smaze
f.smeeb	smeeb
f.smeed	smeed
f.smeef	smeef
f.smeeg	smeeg
f.smeege	smeege
f.smeel	smeel
f.smeem	smeem
f.smeen	smeen
f.smeep	smeep
f.smeese	smeese
f.smeesh	smeesh
f.smeeth	smeeth
f.smeeve	smeeve
f.smeeze	smeeze
f.smobe	smobe
f.smode	smode
f.smofe	smofe
f.smoge	smoge
f.smogue	smogue
f.smole	smole
f.smome	smome
f.smone	smone
f.smoob	smoob
f.smood	smood
f.smoof	smoof
f.smoog	smoog
f.smooge	smooge
f.smool	smool
f.smoom	smoom
f.smoon	smoon
f.smoop	smoop
f.smoose	smoose
f.smoosh	smoosh
f.smoove	smoove
f.smooze	smooze
f.smope	smope
f.smose	smose
f.smoshe	smoshe
f.smothe	smothe
f.smove	smove
f.smoze	smoze
f.snabe	snabe
f.snache	snache
f.snade	snade
f.snafe	snafe
f.snage	snage
f.snague	snague
f.sname	sname
f.snane	snane
f.snase	snase
f.snashe	snashe
f.snathe	snathe
f.snave	snave
f.sneeb	sneeb
f.sneech	sneech
f.sneed	sneed
f.sneef	sneef
f.sneeg	sneeg
f.sneege	sneege
f.sneem	sneem
f.sneen	sneen
f.sneese	sneese
f.sneesh	sneesh
f.sneeth	sneeth
f.sneeve	sneeve
f.snobe	snobe
f.snoche	snoche
f.snode	snode
f.snofe	snofe
f.snoge	snoge
f.snogue	snogue
f.snome	snome
f.snone	snone
f.snoob	snoob
f.snooch	snooch
f.snood	snood
f.snoof	snoof
f.snoog	snoog
f.snooge	snooge
f.snoom	snoom
f.snoon	snoon
f.snoose	snoose
f.snoosh	snoosh
f.snooth	snooth
f.snoove	snoove
f.snose	snose
f.snoshe	snoshe
f.snothe	snothe
f.snove	snove
f.sobe	sobe
f.soche	soche
f.sogue	sogue
f.soob	soob
f.sooch	sooch
f.soog	soog
f.soosh	soosh
f.soshe	soshe
f.spabe	spabe
f.spage	spage
f.spague	spague
f.spame	spame
f.spape	spape
f.spashe	spashe
f.spate	spate
f.spathe	spathe
f.spave	spave
f.speeb	speeb
f.speeg	speeg
f.speege	speege
f.speem	speem
f.speep	speep
f.speesh	speesh
f.speet	speet
f.speeth	speeth
f.speeve	speeve
f.spobe	spobe
f.spoge	spoge
f.spogue	spogue
f.spome	spome
f.spoob	spoob
f.spoog	spoog
f.spooge	spooge
f.spoom	spoom
f.spoop	spoop
f.spoosh	spoosh
f.spoot	spoot
f.spooth	spooth
f.spoove	spoove
f.spope	spope
f.sposhe	sposhe
f.spote	spote
f.spothe	spothe
f.spove	spove
f.stabe	stabe
f.stache	stache
f.stafe	stafe
f.stague	stague
f.stase	stase
f.stashe	stashe
f.stathe	stathe
f.steeb	steeb
f.steech	steech
f.steef	steef
f.steeg	steeg
f.steese	steese
f.steesh	steesh
f.steeth	steeth
f.stobe	stobe
f.stoche	stoche
f.stofe	stofe
f.stogue	stogue
f.stoob	stoob
f.stooch	stooch
f.stoof	stoof
f.stoog	stoog
f.stoose	stoose
f.stoosh	stoosh
f.stooth	stooth
f.stose	stose
f.stoshe	stoshe
f.stothe	stothe
f.swabe	swabe
f.swache	swache
f.swafe	swafe
f.swage	swage
f.swague	swague
f.swale	swale
f.swame	swame
f.swase	swase
f.swathe	swathe
f.swave	swave
f.swaze	swaze
f.sweeb	sweeb
f.sweech	sweech
f.sweef	sweef
f.sweeg	sweeg
f.sweege	sweege
f.sweel	sweel
f.sweem	sweem
f.sweese	sweese
f.sweeth	sweeth
f.sweeve	sweeve
f.sweeze	sweeze
f.swobe	swobe
f.swoche	swoche
f.swofe	swofe
f.swoge	swoge
f.swogue	swogue
f.swole	swole
f.swome	swome
f.swoob	swoob
f.swooch	swooch
f.swoof	swoof
f.swoog	swoog
f.swooge	swooge
f.swool	swool
f.swoom	swoom
f.swoose	swoose
f.swooth	swooth
f.swoove	swoove
f.swooze	swooze
f.swose	swose
f.swothe	swothe
f.swove	swove
f.swoze	swoze
f.tafe	tafe
f.tage	tage
f.tague	tague
f.tashe	tashe
f.tave	tave
f.teef	teef
f.teeg	teeg
f.teege	teege
f.teesh	teesh
f.teeve	teeve
f.thabe	thabe
f.thache	thache
f.thade	thade
f.thafe	thafe
f.thage	thage
f.thague	thague
f.thake	thake
f.thale	thale
f.thane	thane
f.thape	thape
f.thashe	thashe
f.thate	thate
f.thathe	thathe
f.thave	thave
f.theeb	theeb
f.theech	theech
f.theed	theed
f.theef	theef
f.theeg	theeg
f.theege	theege
f.theek	theek
f.theel	theel
f.theen	theen
f.theep	theep
f.theesh	theesh
f.theet	theet
f.theeth	theeth
f.theeve	theeve
f.thobe	thobe
f.thoche	thoche
f.thode	thode
f.thofe	thofe
f.thoge	thoge
f.thogue	thogue
f.thoke	thoke
f.thole	thole
f.thone	thone
f.thoob	thoob
f.thooch	thooch
f.thood	thood
f.thoof	thoof
f.thoog	thoog
f.thooge	thooge
f.thook	thook
f.thool	thool
f.thoon	thoon
f.thoop	thoop
f.thoosh	thoosh
f.thoot	thoot
f.thooth	thooth
f.thoove	thoove
f.thope	thope
f.thoshe	thoshe
f.thote	thote
f.thothe	thothe
f.thove	thove
f.thrabe	thrabe
f.thrache	thrache
f.thrade	thrade
f.thrafe	thrafe
f.thrage	thrage
f.thrague	thrague
f.thrake	thrake
f.thrale	thrale
f.thrame	thrame
f.thrape	thrape
f.thrare	thrare
f.thrashe	thrashe
f.thrathe	thrathe
f.thrave	thrave
f.threeb	threeb
f.threech	threech
f.threed	threed
f.threef	threef
f.threeg	threeg
f.threege	threege
f.threek	threek
f.threel	threel
f.threem	threem
f.threep	threep
f.threer	threer
f.threesh	threesh
f.threeth	threeth
f.threeve	threeve
f.throbe	throbe
f.throche	throche
f.throde	throde
f.throfe	throfe
f.throge	throge
f.throgue	throgue
f.throke	throke
f.throle	throle
f.throme	throme
f.throob	throob
f.throoch	throoch
f.throod	throod
f.throof	throof
f.throog	throog
f.throoge	throoge
f.throok	throok
f.throol	throol
f.throom	throom
f.throop	throop
f.throor	throor
f.throosh	throosh
f.throoth	throoth
f.throove	throove
f.thrope	thrope
f.throre	throre
f.throshe	throshe
f.throthe	throthe
f.throve	throve
f.thwabe	thwabe
f.thwache	thwache
f.thwade	thwade
f.thwafe	thwafe
f.thwage	thwage
f.thwague	thwague
f.thwake	thwake
f.thwale	thwale
f.thwame	thwame
f.thwane	thwane
f.thwape	thwape
f.thware	thware
f.thwase	thwase
f.thwashe	thwashe
f.thwate	thwate
f.thwathe	thwathe
f.thwave	thwave
f.thwaze	thwaze
f.thweeb	thweeb
f.thweech	thweech
f.thweed	thweed
f.thweef	thweef
f.thweeg	thweeg
f.thweege	thweege
f.thweek	thweek
f.thweel	thweel
f.thweem	thweem
f.thween	thween
f.thweep	thweep
f.thweer	thweer
f.thweese	thweese
f.thweesh	thweesh
f.thweet	thweet
f.thweeth	thweeth
f.thweeve	thweeve
f.thweeze	thweeze
f.thwobe	thwobe
f.thwoche	thwoche
f.thwode	thwode
f.thwofe	thwofe
f.thwoge	thwoge
f.thwogue	thwogue
f.thwoke	thwoke
f.thwole	thwole
f.thwome	thwome
f.thwone	thwone
f.thwoob	thwoob
f.thwooch	thwooch
f.thwood	thwood
f.thwoof	thwoof
f.thwoog	thwoog
f.thwooge	thwooge
f.thwook	thwook
f.thwool	thwool
f.thwoom	thwoom
f.thwoon	thwoon
f.thwoop	thwoop
f.thwoor	thwoor
f.thwoose	thwoose
f.thwoosh	thwoosh
f.thwoot	thwoot
f.thwooth	thwooth
f.thwoove	thwoove
f.thwooze	thwooze
f.thwope	thwope
f.thwore	thwore
f.thwose	thwose
f.thwoshe	thwoshe
f.thwote	thwote
f.thwothe	thwothe
f.thwove	thwove
f.thwoze	thwoze
f.tofe	tofe
f.toge	toge
f.togue	togue
f.toof	toof
f.toog	toog
f.tooge	tooge
f.toosh	toosh
f.toove	toove
f.toshe	toshe
f.tove	tove
f.trabe	trabe
f.trache	trache
f.trafe	trafe
f.trage	trage
f.trague	trague
f.trake	trake
f.trame	trame
f.treeb	treeb
f.treech	treech
f.treef	treef
f.treeg	treeg
f.treege	treege
f.treek	treek
f.treem	treem
f.trobe	trobe
f.troche	troche
f.trofe	trofe
f.troge	troge
f.trogue	trogue
f.troke	troke
f.trome	trome
f.troob	troob
f.trooch	trooch
f.troof	troof
f.troog	troog
f.trooge	trooge
f.trook	trook
f.troom	troom
f.twabe	twabe
f.twache	twache
f.twafe	twafe
f.twage	twage
f.twague	twague
f.twale	twale
f.twame	twame
f.twape	twape
f.tware	tware
f.twase	twase
f.twashe	twashe
f.twathe	twathe
f.twave	twave
f.tweeb	tweeb
f.tweech	tweech
f.tweef	tweef
f.tweeg	tweeg
f.tweege	tweege
f.tweel	tweel
f.tweem	tweem
f.tweep	tweep
f.tweer	tweer
f.tweese	tweese
f.tweesh	tweesh
f.tweeth	tweeth
f.tweeve	tweeve
f.twobe	twobe
f.twoche	twoche
f.twofe	twofe
f.twoge	twoge
f.twogue	twogue
f.twole	twole
f.twome	twome
f.twoob	twoob
f.twooch	twooch
f.twoof	twoof
f.twoog	twoog
f.twooge	twooge
f.twool	twool
f.twoom	twoom
f.twoop	twoop
f.twoor	twoor
f.twoose	twoose
f.twoosh	twoosh
f.twooth	twooth
f.twoove	twoove
f.twope	twope
f.twore	twore
f.twose	twose
f.twoshe	twoshe
f.twothe	twothe
f.twove	twove
f.vabe	vabe
f.vade	vade
f.vafe	vafe
f.vage	vage
f.vake	vake
f.vame	vame
f.vape	vape
f.vashe	vashe
f.vave	vave
f.veeb	veeb
f.veed	veed
f.veef	veef
f.veege	veege
f.veek	veek
f.veem	veem
f.veep	veep
f.veesh	veesh
f.veeve	veeve
f.vobe	vobe
f.vode	vode
f.vofe	vofe
f.voge	voge
f.voke	voke
f.vome	vome
f.voob	voob
f.vood	vood
f.voof	voof
f.vooge	vooge
f.vook	vook
f.voom	voom
f.voop	voop
f.voosh	voosh
f.voove	voove
f.vope	vope
f.voshe	voshe
f.vove	vove
f.wache	wache
f.wague	wague
f.wathe	wathe
f.weech	weech
f.weeg	weeg
f.weeth	weeth
f.woche	woche
f.wogue	wogue
f.wooch	wooch
f.woog	woog
f.wooth	wooth
f.wothe	wothe
f.yabe	yabe
f.yache	yache
f.yafe	yafe
f.yage	yage
f.yague	yague
f.yame	yame
f.yane	yane
f.yape	yape
f.yase	yase
f.yashe	yashe
f.yate	yate
f.yave	yave
f.yaze	yaze
f.yeeb	yeeb
f.yeech	yeech
f.yeef	yeef
f.yeeg	yeeg
f.yeege	yeege
f.yeem	yeem
f.yeen	yeen
f.yeep	yeep
f.yeese	yeese
f.yeesh	yeesh
f.yeet	yeet
f.yeeve	yeeve
f.yeeze	yeeze
f.yobe	yobe
f.yoche	yoche
f.yofe	yofe
f.yoge	yoge
f.yogue	yogue
f.yome	yome
f.yone	yone
f.yoob	yoob
f.yooch	yooch
f.yoof	yoof
f.yoog	yoog
f.yooge	yooge
f.yoom	yoom
f.yoon	yoon
f.yoop	yoop
f.yoose	yoose
f.yoosh	yoosh
f.yoot	yoot
f.yoove	yoove
f.yooze	yooze
f.yope	yope
f.yose	yose
f.yoshe	yoshe
f.yote	yote
f.yove	yove
f.yoze	yoze
f.zabe	zabe
f.zache	zache
f.zade	zade
f.zafe	zafe
f.zage	zage
f.zague	zague
f.zake	zake
f.zape	zape
f.zare	zare
f.zashe	zashe
f.zate	zate
f.zathe	zathe
f.zave	zave
f.zeeb	zeeb
f.zeech	zeech
f.zeed	zeed
f.zeef	zeef
f.zeeg	zeeg
f.zeege	zeege
f.zeek	zeek
f.zeep	zeep
f.zeer	zeer
f.zeesh	zeesh
f.zeet	zeet
f.zeeth	zeeth
f.zeeve	zeeve
f.zobe	zobe
f.zoche	zoche
f.zode	zode
f.zofe	zofe
f.zoge	zoge
f.zogue	zogue
f.zoke	zoke
f.zoob	zoob
f.zooch	zooch
f.zood	zood
f.zoof	zoof
f.zoog	zoog
f.zooge	zooge
f.zook	zook
f.zoop	zoop
f.zoor	zoor
f.zoosh	zoosh
f.zoot	zoot
f.zooth	zooth
f.zoove	zoove
f.zope	zope
f.zore	zore
f.zoshe	zoshe
f.zote	zote
f.zothe	zothe
f.zove	zove